11111111
10P00001
1000P001
1E00C001
11111111