111111111
1E00000001
1000C0001
100000P01
111111111