11111111
100E0P01
1C000001
10000E01
11111111