11111111
10000C01
100P0001
10000001
11111111