1111111111111111
10000010001C1001
10000E1000000001
100001100000P001
10C0000000000001
1111111111111111