11111111
10P00001
100A00E1
1C000001
11111111