111111111
1000E0001
100000001
1000000C1
111111111