1111111111111111111111
10000010001C1001000001
100P001000101001010001
1000011000001001010011
10110000000000000100C1
100100000000C000111111
1101000000000000000001
1001000C00000000000001
10C1000000001E10000001
1111111111111111111111