111111111
100P00001
111000101
1C10001E1
111111111