1111111
00P0001
1C00E01
1111111